lv1
#####.##.##...#
##..-------####
.-.#-...#.--..#
.-..-###...-#.#
#-..-...##.-.-#
.-#.----...-#-#
.-.#..#-.#.---#
.-.---.-#......
.---.---.#...#.
#..##....######